Name,Gender,State,Phy,Maths,Bio,Total
rohan,male,mh,60,90,68,218
aniket,male,up,52,85,72,209
ganesh,male,up,45,82,78,205
meena,female,mp,72,69,80,221
seema,female,mh,68,90,78,236
dinesh,male,mp,48,34,67,149
yogita,female,mp,39,65,90,194
karan,male,mh,82,78,55,215
jayesh,male,up,87,88,32,207
mangesh,male,mp,91,78,82,251
geeta,female,mh,31,58,78,167
runali,female,up,85,92,66,243
tushar,male,up,32,92,77,201
binod,male,mh,95,78,88,261
sanjay,male,mh,63,90,80,233
